       111111111111111111
	   100000000000000001
	   100000000000000001
	   100000000000E00001
1111111111111100000000001
11111100000000000000W0001
1100010011100111000000001
11111 111 1111 1111111111