  1111111111
  111111
11111W11
11110001
111111
1 1111