NO ./textures/bluestone.xpm
WE ./textures/bluestone.xpm
SO ./textures/bluestone.xpm
EA ./textures/bluestone.xpm	
F 255,0,0
C 0,0,255

  1111111111111111111
 1100111001101111111111
1110011000000000011
1100111100000000011
111000000000W000011
   111111111111111111
111111111111111111