WE    ./textures/stone_bricks.xpm
SO    ./textures/gold_ore.xpm


EA     	./textures/diamond.xpm  
		F 216,	181,  134
    NO ./textures/emerald_ore.xpm			  
C 148, 216,152


11111111111
11111111111
111000N001
   11110011
   1111111