SO    ./textures/bluestone.xpm
NO ./textures/bluestone.xpm
WE ./textures/bluestone.xpm
EA ./textures/bluestone.xpm
F 255 ,200,54
C 100,80,200

1111111111111111111
    11111111111111111111111          
1111111000000000011
111111110000N000011
1110000000000000011
1111111111111111111


