SO ./textures/gold_ore.xpm
			  
	F 216,181,134
NO      ./textures/stone_bricks.xpm
C 148,   216,252
WE 	./textures/nether.xpm
EA ./textures/diamond.xpm



111111111111111111111111111111
11111111111111111111111111111
11111111111111111111111111111
111111111111111111111111111111
10000000001100000000000000111
11110000011101111111111111111111111111
	111111001000000000100010000000001111111
	1111111111111110110000000N00000000000111111
1000000000110000000000011111111111111111111
111001111100110110000000100011
111001100001000110101001000111
1111000011010100110010000100111
1000000011000111001100010010111
100101100000110000001100011111
1101100111010111111101111011
1100001 1100001 1011000000011
1111111 1111111 111111111111