SO ./path_to_the_south_textur 
NO ./path_to_the_south_textur
NO 
WE ./path_to_the_west_textur
EA ./path_to_the_east_textu
F 11,80,200
C 55,80,200




111111111111111111
1111111111111N111111111
11000111000000000010001
111111111111111111111111
1111 1111111111111111111111
111111 
1111
11111111
10000011
11111111 