SO   ./textures/gold_ore.xpm




	F 216,181,134
NO      ./textures/stone_bricks.xpm
C 148,     216,252
WE 	./textures/dirt.xpm
EA ./textures/diamond.xpm


111111111111111111111111111111 
11111111111111111111111111111
		
11111111111111111111111111111
10000000001100000000000000111
10110000011101111111111111111
10010000N00001000111110001111111
111111111011000001110000000000001
1000000000110000011101111111111111
111001111100110110000000100011
111001100001000110101001000111
1111000011010100110010000100111
1000000011000111001100010010111
100101100000110000001100011111
1101100111010111111101111011
1100001 1100001 1011000000011
1111111 1111111 111111111111
