NO ./textures/stone_bricks.xpm
WE ./textures/furnace_front.xpm
SO ./textures/dirt.xpm
EA ./textures/diamond.xpm	
C 148,216,252
F 216,181,134

        111111111111111111111111111
        10000N000011000000000000001
        10110000011101111111111111
        10010000000001000111110001
111111111011000001110000000000001
100000000011000001110111111111111
11100111110011011000000010001
1110011000010001101010010001
11110000110101001100100001001
10000000110001110011000100101
1001011000001100000011000111
1101100111010111111101111011
1100001 1100001 101100000001
1111111 1111111 111111111111

