SO ./path_to_the_south_textur
NO ./path_to_the_south_textur
WE ./path_to_the_west_textur
EA ./path_to_the_east_textur
C 55,80,250
F 11,80,55


111111111111111111
11111111111111111111111
11000111000000N00010001
111111111111111111111111
11111111111111111111111111
111111 
1111
11111111
10000011
11111111 