NO ./textures/bluestone.xpm
WE ./textures/bluestone.xpm
SO ./textures/bluestone.xpm
EA ./textures/bluestone.xpm	

F 255,0,0
C 100,80,200

  1111111111111111111
   1100111001101111111111
 1110011000000000011
1 10011110000000N011
1110000000000000011
1111111111111111111