SO ./path_to_the_north_textu
NO ./path_to_the_south_textur
WE ./path_to_the_west_textur
EA ./path_to_the_east_textur
C    
F 220,100,
1111111111111111111111111
0011000001110000000000001
0001000000000000000000001
11111111101100000111000001
1000000000110000011101111
11110111111111011100000010001
11110111111111011101010010001
110000001101010111000N0010001
1000000000000001100000010001
10000000000000001101010010001
1100000111010101111101111111
11110111 1110101 10111101000
11111111 1111111 11111111111