NO ./textures/bluestone.xpm
WE ./textures/bluestone.xpm
SO ./textures/bluestone.xpm
EA ./textures/bluestone.xpm	

F 255,0,0
C 100,80,200

1111111111111111111
      1111111111111111111111
1111111000000000011
111111110000000N011
1110000000000000011
1111111111111111111
11111
11011
11111
111
