NO ./textures/bluestone.xpm
WE ./textures/bluestone.xpm
SO ./textures/bluestone.xpm
EA ./textures/bluestone.xpm	
F 8,50,52
C 0,0,80

  1111111111111111111
 11000000000000001111111111
1110000000000000011
1110000000000000011
11100000000E000011
1110000000000000011
111000000100010011
1110000001000100011
1110000001000100011
1110000000111000011
   111111111111111111
111111111111111111