NO ./textures/bluestone.xpm
WE ./textures/bluestone.xpm
SO ./textures/bluestone.xpm
EA ./textures/bluestone.xpm	
F 255,0,0
C 0,0,255

1111111111111111111
110111011101111111111
1110011000000000011
1100111100000000011
1110000000000000011
   111111111111N111111
111111111111111111