SO ./path_to_the_south_textur
NO ./path_to_the_south_textur
WE ./path_to_the_west_textur
EA ./path_to_the_east_textu
F 7,80,5
C 55,80,200

111111111
1110N11
1111111
111
11