		  WE ./textures/stone_bricks.xpm   	
SO      	 	./textures/gold_ore.xpm				   
EA    	./textures/diamond.xpm 			
F 178,	255,  102
NO ./textures/emerald_ore.xpm	

C 51,255,251

11111111111111111111111111111111111111
1
 1111111111111111111111111111	11111            11111111
1000000000110000000001001111111					1111111111
1111110110000011100000N0000001111				1111110011
    1111001000000000000000000001				11111111111
111111111011000001110000000000001
100000000011000001110111111111111
11110111111111011100000010001
11110111111111011101010010001
11000000110101011100000010001
10000000000000001100000010001		
10000000000000001101010010001
1100000111010101111101111000111
11110111 1110101 111111010001
11111111 1111111 	1111111111111111







