SO ./path_to_the_north_textu
NO ./path_to_the_south_textur
WE ./path_to_the_west_textur
EA ./path_to_the_east_textur
C    
F 220,100,

11111111 1111111111111111
100000011100000S00000001
10000111011111100000001
1111110001111111111111111
11111111111111111111N111111